..........................#
...........................
.....###########...........
...............#...........
...............#...........
...............#...........
...............#...........
...........................
...........................
.........#.................
.........#........#........
.........###...............
...........................
...........................
..................#........
...........................
.....##########............
...........................
..................#........
...........................
#.........................#